blue: 0,A
red: 1,B
yellow: 2,C
magenta: 3,D
blue: 4,E
cyan: 5,F
green: 6,G
++++++++++++++++++++++++++++++
+ABCDEFG0123456              +
+++++++++++++++++++++++      +
+abcderfg                    +
+ + + + +++++++++++++++      +
+ + + + +++++++++++++++      +
++++++++++++++++++++++++++++++
