red: 0,A
green: 1,B
+++++++++++++++++
+      + b+     +
+      + B+     +
+      +  +     +
+      +  +aA   +
+      +  ++    +
+1       0      +
+++++++++++++++++
