     +++
     + +
     + +     +++
++++++ +++++++ +++
+B  C   A    D  b+
+++++++++++ ++++++
          +0+
          + +
          + ++++++
          +      +
          ++++++++