blue: 0,A
red: 1,B
+++++++++++
+++++1+++++
+++++ +++++
++++   ++++
+0  AB   a+
+++++++++++