++++++++++++++++
+  +1+ +3+ +5+ +
+  + + + + + + +
+  + + + + + + +++
+0A C D E F G H a+
+  + + + + + + +++
+  + + + + + + +
+  + +2+ +4+ +6+
++++++++++++++++