+++++++++++++
+1A        a+
+++++++++++++
+0B        b+
+++++++++++++
