+++++++++++++++++++++++++++++++++++++++++
+aA                                     +
+aA0B                                   +
+                                       +
+++++++++++++++++++++++++++++++++++++++++